+--+--+--+--+--+--+--+--+--+--+--+--+--+--+--+
   |     |     |           |           |     |
   |     |     |           |           |     |
+  +  +  +  +  +  +--+  +  +  +--+--+  +  +  +
|     |     |  |  |     |     |  |     |  |  |
|     |     |  |  |     |     |  |     |  |  |
+--+--+--+--+  +  +--+--+--+  +  +  +--+  +  +
|              |        |     |  |  |     |  |
|              |        |     |  |  |     |  |
+  +--+--+--+--+--+--+  +--+--+  +  +  +--+  +
|     |     |        |        |        |  |  |
|     |     |        |        |        |  |  |
+--+  +  +  +  +--+  +--+--+  +--+  +  +  +  +
|     |  |     |  |     |     |     |  |     |
|     |  |     |  |     |     |     |  |     |
+  +--+--+  +--+  +--+  +  +--+  +--+--+--+--+
|        |  |  |        |     |  |           |
|        |  |  |        |     |  |           |
+--+--+  +  +  +  +--+--+--+  +  +  +  +  +--+
|           |     |     |     |  |  |  |     |
|           |     |     |     |  |  |  |     |
+  +--+  +--+  +--+  +  +--+--+  +  +--+--+  +
|     |  |     |     |           |     |     |
|     |  |     |     |           |     |     |
+--+--+  +  +--+  +--+--+--+--+  +--+  +  +--+
|     |  |     |     |     |     |     |     |
|     |  |     |     |     |     |     |     |
+  +  +--+--+  +  +  +  +  +  +--+  +--+  +--+
|  |        |  |  |  |  |  |     |     |     |
|  |        |  |  |  |  |  |     |     |     |
+  +--+--+  +  +  +  +  +  +--+  +--+  +  +  +
|     |  |        |     |     |     |  |  |  |
|  |        |  |  |  |  |  |     |     |     |
+--+  +  +--+--+--+--+--+  +  +--+  +  +  +  +
|  |     |     |        |  |     |     |  |  |
|  |     |     |        |  |     |     |  |  |
+  +--+  +--+  +--+--+  +--+--+  +--+--+--+  +
|           |     |              |     |     |
|           |     |              |     |     |
+--+--+  +  +--+  +  +  +--+--+  +  +  +  +--+
|     |  |        |  |        |  |  |  |  |  |
|     |  |        |  |        |  |  |  |  |  |
+  +--+  +--+--+--+  +--+--+  +  +--+  +  +  +
|        |           |        |        |      
|        |           |        |        |     
+--+--+--+--+--+--+--+--+--+--+--+--+--+--+--+